 >Chorus >Chorus >Trans >Verse >Chorus >Trans >Verse >Chorus >Trans >Chorus	UB40_RedRedWine_1984.hum
 >Chorus >Trans >Verse >Chorus >Trans >Verse >Chorus >Trans >Bridge >Chorus >Trans >Outro >>Fadeout	TheRascals_PeopleGotToBeFree_1968.hum
 >Chorus >Verse >Chorus >Bridge >Chorus >Verse >Instrumental >Chorus >Bridge >Verse >Chorus >Instrumental >Outro >>Fadeout	GeorgeHarrison_GotMyMindSetOnYou_1988.hum
 >Chorus >Verse >Chorus >Verse >Chorus	LindaRonstadt_WhenWillIBeLoved_1975.hum
 >Introa >Introb >Verse >Chorus >Trans >Verse >Chorus >Trans >Verse >Chorus >Trans >Outro	CyndiLauper_TrueColors_1986.hum
 >Intro >Chorus >Bridge >Chorus >Solo >Bridge >Chorus	CliffRichard_LivingDoll_1959.hum
 >Intro >Chorus >Chorus >Verse >Chorus >Bridge >Chorus >Bridge >Chorus >Fadeout	BruceChannel_HeyBaby_1962.hum
 >Intro >Chorus >Chorus >Verse >Chorus >Interlude >Solo >Chorus >>Fadeout	SimonAndGarfunkel_Cecilia_1970.hum
 >Intro >Chorus >Trans >Bridge >Chorus >Solo >Trans >Bridge >Chorus >Trans >Chorus >>Fadeout	TheKendalls_HeavensJustASinAway_1977.hum
 >Intro >Chorus >Trans >Verse >Trans >Chorus >Trans >Verse >Trans >Chorus >Trans >Outro >>Fadeout	JFrankWilsonAndTheCavaliers_LastKiss_1964.hum
 >Intro >Chorus >Verse >Bridge >Chorus >Solo >Bridge >Chorus >Outro	TheBeatles_AHardDaysNight_1964.hum
 >Intro >Chorus >Verse >Chorus >Bridge >Verse >Chorus >Bridge >Chorus >>Fadeout	OakRidgeBoys_Elvira_1981.hum
 >Intro >Chorus >Verse >Chorus >Verse >Bridge >Chorus >Verse >Outro	TheRollingStones_TimeIsOnMySide_1964.hum
 >Intro >Chorus >Verse >Chorus >Verse >Chorus >Chorus >Verse >Chorus >Chorus >>Fadeout	TheMiracles_IDontBlameYouAtAll_1971.hum
 >Intro >Chorus >Verse >Chorus >Verse >Chorus >Verse >Chorus >Verse >Bridge >Chorus >Verse >Chorus	TheLas_ThereSheGoes_1991.hum
 >Intro >Chorus >Verse >Chorus >Verse >Chorus >Verse >Chorus >Verse >Chorus >>Fadeout	EdwinStarr_War_1970.hum
 >Intro >Chorus >Verse >Chorus >Verse >Chorus >Verse >Chorus >Verse >Chorus >>Fadeout	JohnnyHorton_JohnnyReb_1959.hum
 >Intro >Chorus >Verse >Chorus >Verse >Chorus >Verse >Outro >>Fadeout	ElvisPresley_LittleSister_1961.hum
 >Intro >Chorus >Verse >Interlude >Chorus >Verse >Chorus >Bridge >Chorus >Outro >>Fadeout	Commodores_Lady_1981.hum
 >Intro >Chorus >Verse >Prechorus >Chorus >Verse >Prechorus >Bridge >Solo >Prechorus >Interlude >Chorus >>Fadeout	CheapTrick_DreamPolice_1979.hum
 >Intro >Chorus >Verse >Solo >Verse >Solo >Interlude >Chorus >Outro	TheDoors_RidersOnTheStorm_1971.hum
 >Intro >Chorus >Verse >Verse >Solo	TheKinks_TillTheEndOfTheDay_1966.hum
 >Intro >Instrumental >Chorus >Verse >Prechorus >Chorus >Verse >Prechorus >Chorus >Bridge >Verse >Prechorus >Chorus >Verse >Solo >Chorus >Chorus >Solo	MarkyMark_GoodVibrations_1991.hum
 >Intro >Instrumental >Verse >Prechorus >Chorus >Instrumental >Verse >Prechorus >Chorus >Chorus >>Fadeout	Commodores_Nightshift_1985.hum
 >Intro >Instrumental >Verse >Prechorus >Chorus >Interlude >Verse >Prechorus >Chorus >Chorus >Interlude >Instrumental >Prechorus >Chorus >Chorus >Chorus >Coda	CyndiLauper_TheGooniesRGoodEnough_1985.hum
 >Intro >Instrumental >Verse >Verse >Chorus >Verse >Chorus >Trans >Verse >Chorus >Outro	TheJGeilsBand_FreezeFrame_1982.hum
 >Intro >Interlude >Instrumental >Verse >Verse >Bridge >Verse >Verse >Bridge >Interlude >Instrumental >Interlude >Instrumental >Outro	Rush_TheSpiritOfRadio_1980.hum
 >Intro >Interlude >Trans >Verse >Chorus >Trans >Verse >Chorus >Interlude >Trans >Solo >Trans >Bridge >Chorus >Solo >Outro	BillyIdol_RebelYell_1984.hum
 >Intro >Interlude >Verse >Chorus >Interlude >Verse >Chorus >Bridge >Verse >Chorus >Outro >>Fadeout	SammyHagar_ICantDrive55_1984.hum
 >Intro >Interlude >Verse >Chorus >Interlude >Verse >Chorus >Chorus >Trans >Bridge >Chorus >Chorus >Chorus >Fadeout	PhilCollins_TwoHearts_1989.hum
 >Intro >Interlude >Verse >Chorus >Trans >Verse >Chorus >Trans >Bridge >Chorus >>Fadeout	VillagePeople_InTheNavy_1979.hum
 >Intro >Interlude >Verse >Prechorus >Chorus >Interlude >Verse >Prechorus >Chorus >Interlude >Solo >Chorus >Chorus >Outro	Kiss_RocketRide_1978.hum
 >Intro >Intro >Instrumental >Bridge >Verse >Bridge >Chorus >Verse >Bridge >Chorus >Verse >Bridge >Chorus >Bridge >Chorus >Outro	Chicago_DoesAnybodyReallyKnowWhatTimeItIs_1970.hum
 >Intro >Intro >Verse >Chorus >Verse >Chorus >Instrumental >Solo >Chorus >>Fadeout	MichaelJackson_BeatIt_1983.hum
 >Intro >Intro >Verse >Chorus >Verse >Chorus >Interlude >Bridge >Verse >Chorus	Madonna_OhFather_1990.hum
 >Intro >Intro >Verse >Chorus >Verse >Chorus >Transition >Transition >Bridge >Verse >Chorus >Outro	Genesis_Abacab_1982.hum
 >Intro >Intro >>Verse >Refrain >Verse >Refrain >Chorus >Bridge >Refrain >Verse >Refrain >Chorus >Bridge >Refrain >Outro >>Fadeout	PetShopBoys_WhatHaveIDoneToDeserveThis_1988.hum
 >Intro	MilliVanilli_BabyDontForgetMyNumber_1989.hum
 >Intro >Preverse >Verse >Verse >Chorus >Preverse >Verse >Chorus >Preverse >Verse >Fadeout	TheWho_PinballWizard_1969.hum
 >Intro >Preverse >Verse >Verse >>Interlude >Solo >Verse >Outro	LedZeppelin_OverTheHillsAndFarAway_1973.hum
 >Intro >Solo >Verse >Chorus >Verse >Chorus >Bridge >Solo >Chorus >Bridge >Chorus >Outro >>Fadeout	PetShopBoys_AlwaysOnMyMind_1988.hum
 >Intro >Theme >Theme >Theme >Theme	BingCrosby_WhiteChristmas_1962.hum
 >Intro >Trans >Verse >Chorus >Trans >Verse >Chorus >Bridge >Solo >Bridge >Chorus >Outro	VanHalen_WhenItsLove_1988.hum
 >Intro >Trans >Verse >Chorus >Trans >Verse >Chorus >Trans >Verse >Trans >>Fadeout	SoftCell_TaintedLove_1982.hum
 >Intro >Trans >Verse >Trans >Verse >Trans >Bridge >Verse >Trans >Outro >>Fadeout	EricCarmen_Sunrise_1976.hum
 >Intro >Trans >Verse >Trans >Verse >Trans >Verse >Trans >Verse >Trans >Interlude	NittyGrittyDirtBand_BuyForMeTheRain_1967.hum
 >Intro >Verse >Bridge >Chorus >Verse >Bridge >Chorus >Solo >Chorus >Chorus >Chorus	TheRonettes_BeMyBaby_1963.hum
 >Intro >Verse >Bridge >Trans >Verse >Outro	JamesBrown_GetUp_1970.hum
 >Intro >Verse >Bridge >Verse >Bridge >Chorus >Interlude >Verse >Chorus >Outro	Steppenwolf_BornToBeWild_1968.hum
 >Intro >Verse >Bridge >Verse >Bridge >Verse >Outro >>Fadeout	LedZeppelin_DyerMaker_1973.hum
 >Intro >Verse >Bridge >Verse >Trans >Fadeout	SonnyAndCher_AllIEverNeedIsYou_1971.hum
 >Intro >Verse >Chorus >Bridge >Interlude >Verse >Chorus >Bridge >Interlude >Verse >Solo >>Fadeout	RickJames_SuperFreak_1981.hum
 >Intro >Verse >Chorus >Bridge >Verse >Outro >>Fadeout	TheWeatherGirls_ItsRainingMen_1983.hum
 >Intro >Verse >Chorus >Chorus >Chorus >Verse >Chorus >Chorus >Chorus	EltonJohn_GoodbyeYellowBrickRoad_1973.hum
 >Intro >Verse >Chorus >Instrumental >Chorus >Outro	AlGreen_OhMeOhMy_1975.hum
 >Intro >Verse >Chorus >Interlude >Bridge >Chorus >Outro >>Fadeout	TheCrystals_HesARebel_1962.hum
 >Intro >Verse >Chorus >Interlude >Interlude >Chorus >Outro	LouisArmstrong_HelloDolly_1964.hum
 >Intro >Verse >Chorus >Interlude >Verse >Chorus >Bridge >Outro	WilsonPhillips_HoldOn_1990.hum
 >Intro >Verse >Chorus >Interlude >Verse >Chorus >Bridge >Verse >Chorus >Instrumental >Verse >Chorus >Outro	JoniMitchell_BabyIDontCare_1982.hum
 >Intro >Verse >Chorus >Interlude >Verse >Chorus >Coda	JohnDenver_SeasonsOfTheHeart_1982.hum
 >Intro >Verse >Chorus >Interlude >Verse >Chorus >Instrumental >Preverse >Verse >Chorus >Outro	Chicago_25Or6To4_1970.hum
 >Intro >Verse >Chorus >Interlude >Verse >Chorus >Interlude >Bridge >Verse >Chorus >>Fadeout	Roxette_TheLook_1989.hum
 >Intro >Verse >Chorus >Interlude >Verse >Chorus >Interlude >Solo >Chorus >Interlude >Verse >Chorus >Interlude >Chorus >Chorus >Outro	GeorgeHarrison_CrackerboxPalace_1977.hum
 >Intro >Verse >Chorus >Interlude >Verse >Chorus >Interlude >Solo >Solo >Solo >Chorus >Chorus >Interlude >Outro	BachmanTurnerOverdrive_RollOnDownTheHighway_1975.hum
 >Intro >Verse >Chorus >Interlude >Verse >Chorus >Interlude >Solo >Verse >Chorus >Chorus	TheBeachBoys_Kokomo_1988.hum
 >Intro >Verse >Chorus >Interlude >Verse >Chorus >Interlude >Verse >Chorus >Interlude >Solo >Chorus >Outro	GeorgeHarrison_BlowAway_1979.hum
 >Intro >Verse >Chorus >Interlude >Verse >Chorus >Interlude >Verse >Chorus >Outro >>Fadeout	JohnDenver_RockyMountainHigh_1972.hum
 >Intro >Verse >Chorus >Interlude >Verse >Chorus >Interlude >Verse >Chorus >Outro >>Fadeout	NancySinatra_TheseBootsAreMadeForWalkin_1966.hum
 >Intro >Verse >Chorus >Interlude >Verse >Chorus >Solo >Verse >Chorus >Chorus >Outro	EricClapton_LayDownSally_1978.hum
 >Intro >Verse >Chorus >Solo >Chorus >Verse >Solo >Solo >Fadeout	PaulMcCartney_MaybeImAmazed_1977.hum
 >Intro >Verse >Chorus >Trans >Verse >Chorus >Bridge >Chorus >Fadeout	PaulRevereAndTheRaiders_Kicks_1966.hum
 >Intro >Verse >Chorus >Trans >Verse >Chorus >Fadeout	PaulSimon_50WaysToLeaveYourLover_1976.hum
 >Intro >Verse >Chorus >Trans >Verse >Chorus >Outro >>Fadeout	JamesBrown_ColdSweatPart1_1967.hum
 >Intro >Verse >Chorus >Trans >Verse >Chorus >Outro	The5thDimension_IfICouldReachYou_1972.hum
 >Intro >Verse >Chorus >Trans >Verse >Chorus >Trans >Bridge >Chorus >Trans >Verse >Instrumental >>Fadeout	BruceSpringsteen_MyHometown_1985.hum
 >Intro >Verse >Chorus >Trans >Verse >Chorus >Trans >Chorus >Coda	AnneMurray_CouldIHaveThisDance_1980.hum
 >Intro >Verse >Chorus >Trans >Verse >Chorus >Trans >Interlude >Chorus >Outro	DavidBowie_BlueJean_1984.hum
 >Intro >Verse >Chorus >Trans >Verse >Chorus >Trans >Verse >Chorus >Trans >Verse >Chorus >Outro >>Fadeout	SimonAndGarfunkel_MrsRobinson_1968.hum
 >Intro >Verse >Chorus >Trans >Verse >Verse >Chorus >Trans >Verse >Verse >Chorus >Outro	JerryJeffWalker_MrBojangles_1968.hum
 >Intro >Verse >Chorus >Verse >Chorus >Bridge >Chorus >Chorus >Interlude >Solo >>Fadeout	U2_WithOrWithoutYou_1987.hum
 >Intro >Verse >Chorus >Verse >Chorus >Bridge >Chorus	EarthWindAndFire_September_1979.hum
 >Intro >Verse >Chorus >Verse >Chorus >Bridge >Chorus >Outro	Oliver_GoodMorningStarshine_1969.hum
 >Intro >Verse >Chorus >Verse >Chorus >Bridge >Chorus >Verse >Chorus >Bridge >Chorus >Outro	LittleRiverBand_Reminiscing_1978.hum
 >Intro >Verse >Chorus >Verse >Chorus >Bridge >Instrumental >Verse >Bridge >Outro	PeterGabriel_ShockTheMonkey_1982.hum
 >Intro >Verse >Chorus >Verse >Chorus >Bridge >Interlude >Verse >Chorus >Bridge >Outro	NakedEyes_AlwaysSomethingThereToRemindMe_1983.hum
 >Intro >Verse >Chorus >Verse >Chorus >Bridge >Interlude >Verse >Chorus >Interlude >Verse >Chorus >Verse >Chorus	PeggyLee_Fever_1958.hum
 >Intro >Verse >Chorus >Verse >Chorus >Bridge >Interlude >Verse >Chorus >Solo >Verse >Chorus >Solo >>Fadeout	TheRollingStones_MissYou_1978.hum
 >Intro >Verse >Chorus >Verse >Chorus >Bridge >Solo >Chorus >Chorus >Chorus >>Fadeout	CultureClub_KarmaChameleon_1984.hum
 >Intro >Verse >Chorus >Verse >Chorus >Bridge >Solo >Chorus >Verse >Chorus >Coda	PaulMcCartneyAndWings_MyLove_1973.hum
 >Intro >Verse >Chorus >Verse >Chorus >Bridge >Solo >Chorus >Verse >Chorus >Outro	TheHollies_CarrieAnne_1967.hum
 >Intro >Verse >Chorus >Verse >Chorus >Bridge >Verse >Chorus >Bridge >Verse >Chorus >Coda	TheBeatles_ObLaDiObLaDa_1976.hum
 >Intro >Verse >Chorus >Verse >Chorus >Bridge >Verse >Chorus >Chorus	CorneliusBrothersAndSisterRose_TreatHerLikeALady_1971.hum
 >Intro >Verse >Chorus >Verse >Chorus >Bridge >Verse >Chorus >>Fadeout	TheBeachBoys_InMyRoom_1963.hum
 >Intro >Verse >Chorus >Verse >Chorus >Bridge >Verse >Chorus >Instrumental >Chorus >>Fadeout	TheShirelles_WillYouLoveMeTomorrow_1961.hum
 >Intro >Verse >Chorus >Verse >Chorus >Bridge >Verse >Chorus >Outro >>Fadeout	OtisRedding_TheDockOfTheBay_1968.hum
 >Intro >Verse >Chorus >Verse >Chorus >Bridge >Verse >Chorus >Outro	LittleRiverBand_HelpIsOnItsWay_1977.hum
 >Intro >Verse >Chorus >Verse >Chorus >Bridge >Verse >Chorus >Outro	TomJones_ShesALady_1971.hum
 >Intro >Verse >Chorus >Verse >Chorus >Bridge >Verse >Chorus >Solo >Fadeout	AnitaBaker_SweetLove_1986.hum
 >Intro >Verse >Chorus >Verse >Chorus >Bridge >Verse >Chorus >Solo >Outro	PatBenatar_Heartbreaker_1980.hum
 >Intro >Verse >Chorus >Verse >Chorus >Bridge >Verse >Chorus >Solo >Verse >Chorus >Outro	BillyJoel_DontAskMeWhy_1980.hum
 >Intro >Verse >Chorus >Verse >Chorus >Chorus >Interlude >Chorus >>Fadeout	GloriaGaynor_NeverCanSayGoodbye_1975.hum
 >Intro >Verse >Chorus >Verse >Chorus >Chorus >Solo >Verse >Chorus >Chorus	Donovan_SunshineSuperman_1966.hum
 >Intro >Verse >Chorus >Verse >Chorus >Instrumental >Verse >Chorus >Fadeout	Cream_SunshineOfYourLove_1968.hum
 >Intro >Verse >Chorus >Verse >Chorus >Interlude >Bridge >Outro >>Fadeout	Chicago_FeelinStrongerEveryDay_1973.hum
 >Intro >Verse >Chorus >Verse >Chorus >Interlude >Chorus >>Fadeout	LesleyGore_CaliforniaNights_1967.hum
 >Intro >Verse >Chorus >Verse >Chorus >Interlude >Chorus >Outro	DavidRuffinAndJimmyRuffin_StandByMe_1970.hum
 >Intro >Verse >Chorus >Verse >Chorus >Interlude >Solo >Verse >Chorus >Chorus >Interlude >Outro	EricClapton_LetItRain_1972.hum
 >Intro >Verse >Chorus >Verse >Chorus >Interlude >Verse >Chorus >Chorus >Chorus >Chorus >>Fadeout	FontellaBass_RescueMe_1965.hum
 >Intro >Verse >Chorus >Verse >Chorus >Modulation >Verse >Chorus	JohnnyCash_IGotStripes_1959.hum
 >Intro >Verse >Chorus >Verse >Chorus >Outro	StephanieMills_NeverKnewLoveLikeThisBefore_1980.hum
 >Intro >Verse >Chorus >Verse >Chorus >Solo >Chorus >Chorus	TheRollingStones_HonkyTonkWomen_1969.hum
 >Intro >Verse >Chorus >Verse >Chorus >Solo >Chorus >Verse >Chorus	CreedenceClearwaterRevival_BadMoonRising_1969.hum
 >Intro >Verse >Chorus >Verse >Chorus >Solo >Fadeout	Level42_SomethingAboutYou_1986.hum
 >Intro >Verse >Chorus >Verse >Chorus >Solo >Verse >Chorus >Chorus >Chorus >Solo >>Fadeout	BruceSpringsteen_ImGoinDown_1985.hum
 >Intro >Verse >Chorus >Verse >Chorus >Solo >Verse >Chorus >Chorus	ChubbyChecker_TheTwist_1962.hum
 >Intro >Verse >Chorus >Verse >Chorus >Solo >Verse >Chorus >Chorus >Outro >>Fadeout	JuiceNewton_QueenOfHearts_1981.hum
 >Intro >Verse >Chorus >Verse >Chorus >Solo >Verse >Chorus >Chorus >Solo >>Fadeout	TheEagles_AlreadyGone_1974.hum
 >Intro >Verse >Chorus >Verse >Chorus >Solo >Verse >Chorus >Coda >Outro >>Fadeout	SpandauBallet_True_1983.hum
 >Intro >Verse >Chorus >Verse >Chorus >Solo >Verse >Chorus >Fadeout	StevieB_BecauseILoveYou_1991.hum
 >Intro >Verse >Chorus >Verse >Chorus >Solo >Verse >Chorus >Solo >Chorus	TheRollingStones_WildHorses_1971.hum
 >Intro >Verse >Chorus >Verse >Chorus >Solo >Verse >Outro >>Fadeout	Blondie_OneWayOrAnother_1979.hum
 >Intro >Verse >Chorus >Verse >Chorus >Trans >Verse >Chorus >Trans >Verse >Chorus >Trans >Verse >Chorus >Outro	HankSnow_IveBeenEverywhere_1962.hum
 >Intro >Verse >Chorus >Verse >Chorus >Verse >Chorus >Bridge >Verse >Chorus >Chorus	TheTrammps_DiscoInferno_1977.hum
 >Intro >Verse >Chorus >Verse >Chorus >Verse >Chorus	DonnaSummer_LastDance_1978.hum
 >Intro >Verse >Chorus >Verse >Chorus >Verse >Chorus >Instrumental >Chorus >>Fadeout	ThePolice_DontStandSoCloseToMe_1981.hum
 >Intro >Verse >Chorus >Verse >Chorus >Verse >Chorus >Outro	JanAndDean_TheLittleOldLady_1964.hum
 >Intro >Verse >Chorus >Verse >Chorus >Verse >Chorus >Solo >Verse >Chorus >Verse >Chorus	JoniMitchell_BigYellowTaxi_1975.hum
 >Intro >Verse >Chorus >Verse >Chorus >Verse >Chorus	TheBeatles_Help_1965.hum
 >Intro >Verse >Chorus >Verse >Chorus >Verse >Chorus >Verse >Chorus	SimonAndGarfunkel_AHazyShadeOfWinter_1966.hum
 >Intro >Verse >Chorus >Verse >Solo >Verse >Chorus >Verse	RogerMiller_YouCantRollerSkateInABuffaloHerd_1966.hum
 >Intro >Verse >Chorus >Verse >Verse >Chorus >Solo >Bridge >Chorus >Chorus >>Fadeout	Rockwell_SomebodysWatchingMe_1984.hum
 >Intro >Verse >Interlude >Verse >Chorus >Interlude >Verse >Chorus >Interlude >Outro >>Fadeout	DepecheMode_WorldInMyEyes_1990.hum
 >Intro >Verse >Interlude >Verse >Chorus >Interlude >Verse >Chorus >Interlude >Solo >Interlude >Verse >Chorus >Interlude >Outro >>Fadeout	TheBeatles_ComeTogether_1969.hum
 >Intro >Verse >Interlude >Verse >Interlude >Bridge >Verse >Interlude >Solo >Trans >Verse >Outro >>Fadeout	TheBeatles_LoveMeDo_1964.hum
 >Intro >Verse >Prechorus >Chorus >Chorus >Verse >Prechorus >Chorus >Solo >Outro	DarylHallAndJohnOates_KissOnMyList_1981.hum
 >Intro >Verse >Prechorus >Chorus >Interlude >Bridge >Solo >Verse >Chorus >Bridge >Chorus	AliceCooper_SchoolsOut_1972.hum
 >Intro >Verse >Prechorus >Chorus >Interlude >Verse >Prechorus >Chorus >Interlude >Prechorus >Solo	AnitaBaker_CaughtUpInTheRapture_1987.hum
 >Intro >Verse >Prechorus >Chorus >Interlude >Verse >Prechorus >Chorus >Interlude >Solo >Prechorus >Instrumental >Chorus >Outro	Wham_WakeMeUpBeforeYouGoGo_1984.hum
 >Intro >Verse >Prechorus >Chorus >Interlude >Verse >Prechorus >Chorus >Prechorus >Chorus >Chorus >Chorus >Chorus >Fadeout	AndyGibb_ShadowDancing_1978.hum
 >Intro >Verse >Prechorus >Chorus >Interlude >Verse >Prechorus >Chorus >Solo >Prechorus >Chorus >>Fadeout	DrHook_SexyEyes_1980.hum
 >Intro >Verse >Prechorus >Chorus >Interlude >Verse >Prechorus >Chorus >Solo >Verse >Prechorus >Chorus >Chorus >Outro	SimpleMinds_SanctifyYourself_1986.hum
 >Intro >Verse >Prechorus >Chorus >Trans >Verse >Prechorus >Chorus >Solo >Prechorus >Chorus >Trans >Outro >>Fadeout	Heart_WhoWillYouRunTo_1987.hum
 >Intro >Verse >Prechorus >Chorus >Trans >Verse >Prechorus >Chorus >Trans >Chorus >Outro >>Fadeout	TheElectricPrunes_IHadTooMuchToDream_1967.hum
 >Intro >Verse >Prechorus >Chorus >Verse >Prechorus >Chorus >Bridge >Solo >Chorus >Chorus >>Fadeout	TinaTurner_WeDontNeedAnotherHero_1985.hum
 >Intro >Verse >Prechorus >Chorus >Verse >Prechorus >Chorus >Bridge >Solo >Solo >Verse >Prechorus >Chorus >Instrumental >Outro >>Fadeout	JudasPriest_YouveGotAnotherThingComin_1982.hum
 >Intro >Verse >Prechorus >Chorus >Verse >Prechorus >Chorus >Bridge >Verse >Prechorus >Chorus >Bridge >Verse >Prechorus >Chorus >Outro	TheBeatles_EightDaysAWeek_1965.hum
 >Intro >Verse >Prechorus >Chorus >Verse >Prechorus >Chorus >Chorus >Chorus >>Fadeout	HarryChapin_SundayMorningSunshine_1972.hum
 >Intro >Verse >Prechorus >Chorus >Verse >Prechorus >Chorus >Instrumental >Prechorus >Chorus >>Fadeout	LeoSayer_YouMakeMeFeelLikeDancing_1977.hum
 >Intro >Verse >Prechorus >Chorus >Verse >Prechorus >Chorus >Interlude >Outro	DuranDuran_IsThereSomethingIShouldKnow_1983.hum
 >Intro >Verse >Prechorus >Chorus >Verse >Prechorus >Chorus >Solo >Bridge >Chorus >>Fadeout	TinaTurner_WhatsLoveGotToDoWithIt_1984.hum
 >Intro >Verse >Prechorus >Chorus >Verse >Prechorus >Chorus >Solo >Solo >Prechorus >Chorus >Chorus >Chorus >Chorus	Quarterflash_HardenMyHeart_1982.hum
 >Intro >Verse >Prechorus >Chorus >Verse >Prechorus >Chorus >Solo >Verse >Chorus >Chorus >>Fadeout	GinoVannelli_WildHorses_1987.hum
 >Intro >Verse >Prechorus >Prechorus >Chorus >Trans >Prechorus >Chorus >Outro	TheKinks_BetterThings_1981.hum
 >Intro >Verse >Prechorus >Trans >Verse >Prechorus >Trans >Chorus >Solo >Chorus >Outro	REOSpeedwagon_TimeForMeToFly_1980.hum
 >Intro >Verse >Preverse >Verse >Chorus >Verse >Chorus >Bridge >Solo >Chorus >Chorus >Fadeout	Whitesnake_HereIGoAgain_1987.hum
 >Intro >Verse >Refrain >Verse >Refrain >Verse >Refrain >Chorus >Verse >Refrain >Chorus >>Fadeout	EltonJohn_WhoWearsTheseShoes_1984.hum
 >Intro >Verse >Solo >Solo >Verse	CreedenceClearwaterRevival_IPutASpellOnYou_1968.hum
 >Intro >Verse >Solo >Verse >Chorus >Solo >Verse >Chorus >Solo >Verse >Chorus >Chorus >Outro	LynyrdSkynyrd_SweetHomeAlabama_1974.hum
 >Intro >Verse >Trans >Chorus >Trans >Verse >Trans >Chorus >Interlude >Chorus >Solo >Solo >Solo >Chorus	Heart_MagicMan_1976.hum
 >Intro >Verse >Transition >Prechorus >Chorus >Verse >Transition >Prechorus >Chorus >Bridge >Chorus >Verse >Chorus >Chorus >Solo >Solo >Chorus	Heart_CrazyOnYou_1978.hum
 >Intro >Verse >Trans >Verse >Chorus >Trans >Bridge >Verse >Chorus >Outro	Queensryche_SilentLucidity_1991.hum
 >Intro >Verse >Trans >Verse >Chorus >Trans >Verse >Chorus >Interlude >Trans >Verse >Chorus >Chorus	BillySquier_TheStroke_1981.hum
 >Intro >Verse >Trans >Verse >Trans >Chorus >Trans >Verse >Trans >Chorus >Fadeout	TheEverlyBrothers_BirdDog_1958.hum
 >Intro >Verse >Trans >Verse >Trans >Prechorus >Chorus >Interlude >Trans >Chorus >Interlude >Prechorus >Chorus >Coda	TheWho_HappyJack_1967.hum
 >Intro >Verse >Trans >Verse >Trans >Solo >Trans >Solo >Trans >Verse >Outro >>Fadeout	TheRobertCrayBand_SmokingGun_1987.hum
 >Intro >Verse >Verse	BingCrosby_SilentNight_1960.hum
 >Intro >Verse >Verse >Bridge >Interlude >Verse >Verse >Chorus >Bridge >Verse >>Outro	GratefulDead_SugarMagnolia_1973.hum
 >Intro >Verse >Verse >Bridge >Outro >>Fadeout	TheMeters_LookKaPyPy_1970.hum
 >Intro >Verse >Verse >Bridge >Solo >Verse >Solo	ElvisPresley_GuitarMan_1968.hum
 >Intro >Verse >Verse >Bridge >Verse >Bridge >Verse	ElvisPresley_OneNight_1959.hum
 >Intro >Verse >Verse >Bridge >Verse >Coda	TheEverlyBrothers_ThatsOldFashioned_1962.hum
 >Intro >Verse >Verse >Bridge >Verse >>Fadeout	TheChiffons_HesSoFine_1963.hum
 >Intro >Verse >Verse >Bridge >Verse >Verse >Outro	GenePitney_TownWithoutPity_1961.hum
 >Intro >Verse >Verse >Chorus >Interlude >Verse >Chorus >Interlude >Verse >Chorus >Outro	EricClapton_WillieAndTheHandJive_1974.hum
 >Intro >Verse >Verse >Chorus >Verse >Chorus >Bridge >Solo >Chorus	TinaTurner_TheBest_1989.hum
 >Intro >Verse >Verse >Chorus >Verse >Chorus >Interlude >Verse >Verse >Chorus >Chorus	SteveMillerBand_RocknMe_1976.hum
 >Intro >Verse >Verse >Chorus >Verse >Chorus >Verse >Interlude >Verse >Outro	TheTurtles_HappyTogether_1967.hum
 >Intro >Verse >Verse >Chorus >Verse >Instrumental >Chorus >Verse >Outro	TheBeatles_ISawHerStandingThere_1964.hum
 >Intro >Verse >Verse >Chorus >Verse >Verse >Chorus	SimonAndGarfunkel_ElCondorPasa_1970.hum
 >Intro >Verse >Verse	DinahWashington_Unforgettable_1959.hum
 >Intro >Verse >Verse >>Fadeout	TheEverlyBrothers_WalkRightBack_1961.hum
 >Intro >Verse >Verse >Instrumental >Verse	BrendaLee_SweetNothins_1960.hum
 >Intro >Verse >Verse >Interlude >Verse >Interlude	JamesBrown_IDontMind_1961.hum
 >Intro >Verse >Verse >Interlude >Verse >Verse >>Fadeout	BillyIdol_WhiteWedding_1983.hum
 >Intro >Verse >Verse >Prechorus >Chorus >Bridge >Interlude >Verse >Prechorus >Chorus >Bridge >Interlude >Outro	CliffRichard_WeDontTalkAnymore_1979.hum
 >Intro >Verse >Verse >Solo >Solo >Verse >Outro	PinkFloyd_Money_1973.hum
 >Intro >Verse >Verse >Solo >Verse >Instrumental	JimmyReed_BabyWhatYouWantMeToDo_1960.hum
 >Intro >Verse >Verse >Solo >Verse	LaVernBaker_ICriedATear_1959.hum
 >Intro >Verse >Verse >Solo >Verse >Solo >Verse >Solo	ChuckBerry_AlmostGrown_1959.hum
 >Intro >Verse >Verse >Solo >Verse >Verse >Outro >>Fadeout	JanAndDean_SidewalkSurfin_1964.hum
 >Intro >Verse >Verse >Transition >Instrumental >Chorus >Chorus	TheChiffons_SweetTalkinGuy_1966.hum
 >Intro >Verse >Verse >Verse >Chorus >Bridge >Solo >Interlude >Verse >Verse >Chorus >Chorus >Outro	BobSeger_LikeARock_1986.hum
 >Intro >Verse >Verse >Verse >Chorus >Interlude >Verse >Verse >Chorus >Interlude >Verse >Verse >Verse >Chorus	TheEagles_LyinEyes_1975.hum
 >Intro >Verse >Verse >Verse >Verse >Bridge >Verse >Verse >Bridge >Verse >Verse	ABBA_HoneyHoney_1974.hum
 >Intro >Verse >Verse >Verse >Verse >Chorus >Verse >Verse >Chorus >Bridge >Verse >Verse >Chorus >Chorus >>Outro	JohnDenver_BackHomeAgain_1974.hum
 >Intro >Verse >Verse >Verse >Verse >Verse	SimonAndGarfunkel_TheSoundsOfSilence_1965.hum
 >Intro >Verse >Verse >Verse >Verse >Verse >Solo >>Fadeout	MarvinGaye_MercyMercyMe_1971.hum
 >Intro >Verse >Verse >Verse >Verse >Verse >Verse >Verse >Verse >Verse >Verse >Verse	ChuckBerry_ReelinAndRockin_1972.hum
 >Solo >Solo >Solo >Solo >Preverse >Verse >Prechorus >Preverse >Verse >Prechorus >Preverse >Prechorus >Solo >Interlude >Solo	Metallica_One_1989.hum
 >Verse >Chorus >Bridge >Verse >Chorus	TheRighteousBrothers_UnchainedMelody_1965.hum
 >Verse >Chorus >Trans >Verse >Chorus >Chorus	Queen_WeAreTheChampions_1978.hum
 >Verse >Chorus >Verse >Chorus >>Interlude >Chorus	AnneMurray_LoveSong_1974.hum
 >Verse >Chorus >Verse >Chorus >Solo >>Fadeout	PinkFloyd_AnotherBrickInTheWall_1980.hum
 >Verse >Chorus >Verse >Chorus >Verse >Chorus >Bridge >Verse >Chorus >Bridge >Outro >>Fadeout	JohnnyHorton_TheBattleOfNewOrleans_1959.hum
 >Verse >Chorus >Verse >Chorus >Verse >>Fadeout	BizMarkie_JustAFriend_1990.hum
 >Verse >Chorus >Verse >Chorus >Verse	JimmyClanton_JustADream_1958.hum
 >Verse >Instrumental >Chorus >Instrumental >Chorus >Verse >Instrumental >Outro	KoolAndTheGang_JungleBoogie_1974.hum
 >Verse >>Interlude >Verse >Solo >Verse >Solo	Santana_EvilWays_1970.hum
 >Verse >Verse >Bridge >Verse >Solo >Bridge >Verse	JohnnyCash_TheWaysOfAWomanInLove_1958.hum
 >Verse >Verse >Chorus >Verse >Chorus >Outro >>Fadeout	ABBA_Chiquitita_1979.hum
 >Verse >Verse >Chorus >Verse >Chorus >Solo >Chorus >Chorus	TheRembrandts_Someone_1991.hum
 >Verse >Verse >Chorus >Verse >Instrumental >Chorus >Verse >Instrumental >>Fadeout	FatsDomino_BeMyGuest_1959.hum
 >Verse >Verse >Solo >Bridge >Verse >Solo >Bridge >Verse >Verse	JamesBrown_IGotYou_1965.hum
